False: 거짓
None: 없음
True: 참
and: 그리고
as: 라고
assert: 참인가
async: 비동기
await: 기다림
break: 종료
class: 모음
continue: 건너뛰기
def: 함수
del: 삭제
elif: 혹은|아니고만약
else: 아니면|모두아니면
except: 예외
finally: 무조건
for: 동안
from: 에서
global: 전역
if: 만약
import: 불러오기
in: 안에
is: 같은가
lambda: 람다
nonlocal: 비지역
not: 부정
or: 또는
pass: 넘어가기
raise: 발생
return: 반환
try: 시도
while: 까지
with: 함께
yield: 생성값